###########S#########
#       #           #
# ##### # ##### #####
# # #   # #   #     #
# # # ### # ####### #
# #     # #       # #
# ##### # # ### ### #
#   #   # # #   #   #
### # ### ### # # ###
#   # #   #   # #   #
# ##### ### ####### #
# #     #   #     # #
# # ####### # ### ###
# # #     #   #   # #
# # # ### ##### # # #
# # #   #     # #   #
# # # # ##### # ### #
# # # # #   # # #   #
# # ### # # # # # ###
#       # #     #   #
###########E#########
